1111111111111111111111111111111111
1E00000000000000000000000000000001
10000100010011111000000000C0000001
1000010001000000100000000000000001
1000010001000001000000000000000001
1000011111000010000000000000000001
1000000001000100000000000000000001
1000000001001000000000000000000001
1000000001001111100000000000000001
1000000000000000000000000000000001
1000000000000000000000000000000001
10000000000000000000000000P0000001
1111111111111111111111111111111111