1111111111111111111111111111111111
1E00000000000000000000000000000001
1001000100111110000C000C00CCCCC001
1001000100000010000C000C000000C001
1001000100000100000C000C00000C0001
1001111100001000000CCCCC0000C00001
10000001000100000000000C000C000001
10000001001000000000000C00C0000001
10000001001111100000000C00CCCCC001
1000000000000000000000000000000001
1000000000000000000000000000000001
1P00000000000000000000000000000001
1111111111111111111111111111111111