1111111111111111111111111111111111
1E00000000000000000000000000000001
10000100010011111000000000C0000001
1000010001000000100000000000000001
1000010001000001000000000000000001
1000011111000010000000000000000001
100000000100010000000P000000000001
1000000001001000000000000000000001
1000000001001111100000000000000001
1000000000000000000000000000000001
1000000000000000000000000000000001
1000000000000000000000000000000001
1111111111111111111111111111111111