11111111111111111111111111111111111
1OPCCOOOOOOOCCCCOOOOOCCOOOOCCCCCCO1
1OCCCCOOOOOCCOOCCOOOCCCCOOOOCCOOCC1
1CCOOCCOOOCCOOOOOOOCCOOCCOOOCCOOCC1
1CCOOCCOOOCCOOOOOOOCCOOCCOOOCCCCCO1
1CCCCCCOOOCCOOOOOOOCCCCCCOOOCCOCCO1
1CCOOCCOOOOCCOOCCOOCCOOCCOOOCCOOCC1
1CCOOCCOOOOOCCCCOOOCCOOCCOOCCCCOCC1
10000000000000000000000000000000001
1CCOOOCCOOCCCCCCCOOOCCCCOOOCCCCCCO1
1CCCOOCCOOOCCOOOCOOOOCCOOOOOCCOOCC1
1CCCCOCCOOOCCOCOOOOOOCCOOOOOCCOOCC1
1CCOCCCCOOOCCCCOOOOOOCCOOOOOCCCCCO1
1CCOOCCCOOOCCOCOOOOOOCCOOOOOCCOCCO1
1CCOOOCCOOOCCOOOCOOOOCCOOOOOCCOOCC1
1CCOOOCCOOCCCCCCCOOOCCCCOOOCCCCOCE1
11111111111111111111111111111111111