111111111111
1P0000000001
100000000001
10000C000001
100000000001
1000000000E1
111111111111