1111111111111111111111111111111111
1E00000000000000000000000000000001
1001000100111110000O000O00OOOOO001
1001000100000010000O000O000000O001
1001000100000100000O000O00000O0001
1001111100001000000OOOOO0000O00001
10000001000100000000000O000O000001
10000001001000000000000O00O0000001
10000001001111100000000O00OOOOC001
1000000000000000000000000000000001
1000000000000000000000000000000001
1P000000000000000000000000000000O1
1111111111111111111111111111111111