111111111111111111111111111111111111
1PCCCCCOOOCCCCCCCOOCCCCCCCOOCCCCOOO1
1OCCOOCCOOOCCOOOCOOOCCOOOCOOOCCOOOO1
1OCCOOCCOOOCCOCOOOOOCCOCOOOOOCCOOOO1
1OCCCCCOOOOCCCCOOOOOCCCCOOOOOCCOOOO1
1OCCOCCOOOOCCOCOOOOOCCOCOOOOOCCOOOC1
1OCCOOCCOOOCCOOOOOOOCCOOOCOOOCCOOCC1
1CCCCOCCOOCCCCOOOOOCCCCCCCOOCCCCCCC1
100000000000000000000000000000000001
1CCCCOOOOCCCCCCOOOCCCCCCCOO0OOOOOOO1
1OCCOOOOOOCCOOCCOOOCCOOOCOO0OOOOOOO1
1OCCOOOOOOCCOOCCOOOCCOCOOOO0OOOOOOO1
1OCCOOOOOOCCCCCOOOOCCCCOOOOCCCCCCOO1
1OCCOOOOOOCCOOOOOOOCCOCOOOOOOOOO0OO1
1OCCOOOOOOCCOOOOOOOCCOOOCOOOOOOO0OO1
1CCCCOOOOCCCCOOOOOCCCCCCCOOOOOOOEOO1
111111111111111111111111111111111111